

NO textures/ceramic_128x128.png
SO textures/leaves_128x128.png
WE textures/ice_128x128.png

EA textures/wood_128x128.png





        1111111111111111111111111
        1000000000110000000000001
        1011000001110000000000001
        1001000000000000000000001
111111111011000001110000000000001
100000000011000001100111111111111
11110111111111011101010010001
11110111111111011101010010001
11000000110101011100000110001
10000000000000001100000110001
100000000000000011010000100001
11000001110101011111N111100111
11110111 1110101 101111010001
11111111 1111111 111111111111
